160 120
1111111111111111111111111111111111111111111111111111111111111111111111111111111111111111111111111111111111111111111111111111111111111111111111111111111111111111
1000000000010000000000000000000000000001000000000000000000000000000000000000000000000000000100000000000000000000000000010000000000000000000000000000000000000001
1000000000010000000000000000000000000001000000000000000000000000000000000000000000000000000100000000000000000000000000010000000000000000000000000000000000000001
1000000000010000000000000000000000000001000000000001111111111110000000000000000000000000000100000000000000000000000000010000000000000000000000000000000000000001
1000000000010000000000000000000000000001000000000001000000000010000000000000000000000000000100000000000000000000000000010000000000000000000000000000000000000001
1000000000010000000000000000000000000001000000000001000000000010000000000000000000000000000100000000000000000000000000010000000000000000000000000000000000000001
1000000000010000000000000000000000000000000000000001000000000010000000000000000000000000000100000000000000000000000000010000000000000000000000000000000000000001
1110000001110000000000000000000000000000000000000000000000000010000000000000000000000000000100000000000000000000000000010000000000000000000000000000000000000001
1000000000010000000000000000000000000000000000000000000000000010000000000000000000000000000000000000000000000000000000000000000000000000000000000000000000000001
1000000000010000000000000000000000000000000000000001000000000010000000000000000000000000000000000000000000000000000000000000000000000000000000000000000000000001
1000000000010000000000000000000000000001000000000001111111111110000000000000000000000000000000000000000000000000000000000000000000000000000000000000000000000001
1000000000010000000000000000000000000001000000000000000000000000000000000000000000000000000000000000000000000000000000000000000000000000000000000000000000000001
1000000000010000000000000000000000000001000000000000000000000000000000000000000000000000000000000000000000000000000000000000000000000000000000000000000000000001
1000000000010000000000000000000000000001000000000000000000000000000000000000000000000000000000000000000000000000000000000000000000000000000000000000000000000001
1000000000010000000000000000000000000001000000000000000000000000000000000000000000000000000100000000000000000000000000010000000000000000000000000000000000000001
1000000000010000000000000000000000000001000000000000000000000000000000000000000000000000000100000000000000000000000000010000000000000000000000000000000000000001
1000000000010000000000000000000000000001000000000000000000000000000000000000000000000000000100000000000000000000000000010000000000000000000000000000000000000001
1000000000010000000000000000000000000001000000000000000000000000000000000000000000000000000100000000000000000000000000010000000000000000000000000000000000000001
1000000000010000000000000000000000000001000000000000000000000000000000000000000000000000000100000000000000000000000000010000000000000000000000000000000000000001
1110000001111111111111111111111111111111000000000000000000000000000000000000000000000000000100000000000000000000000000010000000000000000000000000000000000000001
1000000000010000000000000001000000000000000000000000000000000000000000000000000000000000000100000000000000000000000000010000000000000000000000000000000000000001
1000000000010000000000000001000000000000000000000011111111111110000000000000000000000000000100000000000000000000000000010000000000000000000000000000000000000001
1000000000010000000000000001000000000000000000000010000000000010000000000000000000000000000100000000000000000000000000010000000000000000000000000000000000000001
1000000000010000000000000001000000000000000000000010000000000010000000000000000000000000000100000000000000000000000000010000000000000000000000000000000000000001
1000000000010000000000000001000000000000000000000010000000000010000000000000000000000000000100000000000000000000000000010000000000000000000000000000000000000001
1000000000010000000000000001000000000000000000000010000000000000000000000000000000000000000100000000000000000000000000010000000000000000000000000000000000000001
1000000000000000000000000001000000000000000000000010000000000010000000000000000000000000000100000000000000000000000000010000000000000000000000000000000000000001
1000000000010000000000000001000000000000000000000010000000000010000000000000000000000000000100000000000000000000000000010000000000000000000000000000000000000001
1000000000010000000000000001000000000000000000000010000000000010000000000000000000000000000100000000000000000000000000010000000000000000000000000000000000000001
1000000000010000000000000001000000000000000000000011111111111110000000000000000000000000000000000000000000000000000000000000000000000000000000000000000000000001
1111000011111111111111111111000000000000000000000000000000000000000000000000000000000000000000000000000000000000000000000000000000000000000000000000000000000001
1000000000010000000000100000000000000000000000000000000000000000000000000000000000000000000000000000000000000000000000000000000000000000000000000000000000000001
1000000000010000000000100000000000000000000000000000000000000000000000000000000000000000000000000000000000000000000000000000000000000000000000000000000000000001
1000000000010000000000100000000000000001111111111111111111111111111111000000000000000000000000000000000000000000000000000000000000000000000000000000000000000001
1000000000010000000000100000000000000001000000000000000000000000000000000000000000000000000100000000000000000000000000010000000000000000000000000000000000000001
1000000000010000000000100000000000000001000000000000000000000000000000000000000000000000000100000000000000000000000000010000000000000000000000000000000000000001
1000000000011111000111100000000000000001000000000000000000000000000000000000000000000000000100000000000000000000000000010000000000000000000000000000000000000001
1000000000010000000000000000000000000001000000000000000000000000000000000000000000000000000100000000000000000000000000010000000000000000000000000000000000000001
1000000000010000000000000000000000000001000000000000000000000000000000000000000000000000000100000000000000000000000000010000000000000000000000000000000000000001
1000000000010000000000000000000000000001000000000000000000000000000000000000000000000000000100000000000000000000000000010000000000000000000000000000000000000001
1000000000010000000000000000000000000001000000000000000000000000000000000000000000000000000000000000000000000000000000000000000000000000000000000000000000000001
1000000000010000000000000000000000000001000000000000000000000000000000000000000000000000000000000000000000000000000000000000000000000000000000000000000000000001
1000000000010000000000000000000000000001000000000000000000000000000000000000000000000000000000000000000000000000000000000000000000000000000000000000000000000001
1000000000010000000000000000000000000001000000000000000000000000000000000000000000000000000000000000000000000000000000000000000000000000000000000000000000000001
1000000000010000000000000000000000000001000000000000000000000000000000000000000000000000000000000000000000000000000000000000000000000000000000000000000000000001
1000000000010000000000000000000000000001000000000000000000000000000000000000000000000000000000000000000000000000000000000000000000000000000000000000000000000001
1111101111110000000000000000000000000001000000000000000000000000000000000000000000000000000100000000000000000000000000010000000000000000000000000000000000000001
1000000000000000000000000000000000000001000000000000000000000000000000000000000000000000000100000000000000000000000000010000000000000000000000000000000000000001
1000000000000000000000000000000000000001000000000000000000001111111111111111111100000000000100000000000000000000000000010000000000000000000000000000000000000001
1000000000000000000000000000000000000001000000000000000000000000000000000000000000000000000100000000000000000000000000010000000000000000000000000000000000000001
1000000000000000000000000000000000000001000000000000000000000000000000000000000000000000000100000000000000000000000000010000000000000000000000000000000000000001
1000000000000000000000000000000000000001000000000000000000000000000000000000000000000000000100000000000000000000000000010000000000000000000000000000000000000001
1111111111111110000000011111111100011111000000000000000000000000000000000000000000000000000100000000000000000000000000010000000000000000000000000000000000000001
1000000000010000000000000010000000000001000000000000000000000000000000000000000000000000000100000000000000000000000000010000000000000000000000000000000000000001
1000000000010000000000000010000000000001000000000000000000000000000000000000000000000000000100000000000000000000000000010000000000000000000000000000000000000001
1000000000000000000000000000000000000001000000000000000000000000000000000000000000000000000100000000000000000000000000010000000000000000000000000000000000000001
1000000000000000000000000000000000000001000000000000000000000000000000000000000000000000000100000000000000000000000000010000000000000000000000000000000000000001
1000000000010000000000000010000000000001000000000000000000000000000000000000000000000000000100000000000000000000000000010000000000000000000000000000000000000001
1000000000010000000000000010000000000001000000000000000000000000000000000000000000000000000100000000000000000000000000010000000000000000000000000000000000000001
1000000000010000000000000000000000000001000000000000000000000000000000000000000000000000000100000000000000000000000000010000000000000000000000000000000000000001
1000000000010000000000000000000000000001000000000000000000000000000000000000000000000000000100000000000000000000000000010000000000000000000000000000000000000001
1000000000010000000000000000000000000001000000000000000000000000000000000000000000000000000100000000000000000000000000010000000000000000000000000000000000000001
1000000000010000000000000000000000000001000000000000000000000000000000000000000000000000000100000000000000000000000000010000000000000000000000000000000000000001
1000000000010000000000000000000000000001000000000001111111111110000000000000000000000000000100000000000000000000000000010000000000000000000000000000000000000001
1000000000010000000000000000000000000001000000000001000000000010000000000000000000000000000100000000000000000000000000010000000000000000000000000000000000000001
1000000000010000000000000000000000000001000000000001000000000010000000000000000000000000000100000000000000000000000000010000000000000000000000000000000000000001
1000000000010000000000000000000000000000000000000001000000000010000000000000000000000000000100000000000000000000000000010000000000000000000000000000000000000001
1110000001110000000000000000000000000000000000000000000000000010000000000000000000000000000100000000000000000000000000010000000000000000000000000000000000000001
1000000000010000000000000000000000000000000000000000000000000010000000000000000000000000000000000000000000000000000000000000000000000000000000000000000000000001
1000000000010000000000000000000000000000000000000001000000000010000000000000000000000000000000000000000000000000000000000000000000000000000000000000000000000001
1000000000010000000000000000000000000001000000000001111111111110000000000000000000000000000000000000000000000000000000000000000000000000000000000000000000000001
1000000000010000000000000000000000000001000000000000000000000000000000000000000000000000000000000000000000000000000000000000000000000000000000000000000000000001
1000000000010000000000000000000000000001000000000000000000000000000000000000000000000000000000000000000000000000000000000000000000000000000000000000000000000001
1000000000010000000000000000000000000001000000000000000000000000000000000000000000000000000000000000000000000000000000000000000000000000000000000000000000000001
1000000000010000000000000000000000000001000000000000000000000000000000000000000000000000000100000000000000000000000000010000000000000000000000000000000000000001
1000000000010000000000000000000000000001000000000000000000000000000000000000000000000000000100000000000000000000000000010000000000000000000000000000000000000001
1000000000010000000000000000000000000001000000000000000000000000000000000000000000000000000100000000000000000000000000010000000000000000000000000000000000000001
1000000000010000000000000000000000000001000000000000000000000000000000000000000000000000000100000000000000000000000000010000000000000000000000000000000000000001
1000000000010000000000000000000000000001000000000000000000000000000000000000000000000000000100000000000000000000000000010000000000000000000000000000000000000001
1110000001111111111111111111111111111111000000000000000000000000000000000000000000000000000100000000000000000000000000010000000000000000000000000000000000000001
1000000000010000000000000001000000000000000000000000000000000000000000000000000000000000000100000000000000000000000000010000000000000000000000000000000000000001
1000000000010000000000000001000000000000000000000011111111111110000000000000000000000000000100000000000000000000000000010000000000000000000000000000000000000001
1000000000010000000000000001000000000000000000000010000000000010000000000000000000000000000100000000000000000000000000010000000000000000000000000000000000000001
1000000000010000000000000001000000000000000000000010000000000010000000000000000000000000000100000000000000000000000000010000000000000000000000000000000000000001
1000000000010000000000000001000000000000000000000010000000000010000000000000000000000000000100000000000000000000000000010000000000000000000000000000000000000001
1000000000010000000000000001000000000000000000000010000000000000000000000000000000000000000100000000000000000000000000010000000000000000000000000000000000000001
1000000000000000000000000001000000000000000000000010000000000010000000000000000000000000000100000000000000000000000000010000000000000000000000000000000000000001
1000000000010000000000000001000000000000000000000010000000000010000000000000000000000000000100000000000000000000000000010000000000000000000000000000000000000001
1000000000010000000000000001000000000000000000000010000000000010000000000000000000000000000100000000000000000000000000010000000000000000000000000000000000000001
1000000000010000000000000001000000000000000000000011111111111110000000000000000000000000000000000000000000000000000000000000000000000000000000000000000000000001
1111000011111111111111111111000000000000000000000000000000000000000000000000000000000000000000000000000000000000000000000000000000000000000000000000000000000001
1000000000010000000000100000000000000000000000000000000000000000000000000000000000000000000000000000000000000000000000000000000000000000000000000000000000000001
1000000000010000000000100000000000000000000000000000000000000000000000000000000000000000000000000000000000000000000000000000000000000000000000000000000000000001
1000000000010000000000100000000000000001111111111111111111111111111111000000000000000000000000000000000000000000000000000000000000000000000000000000000000000001
1000000000010000000000100000000000000001000000000000000000000000000000000000000000000000000100000000000000000000000000010000000000000000000000000000000000000001
1000000000010000000000100000000000000001000000000000000000000000000000000000000000000000000100000000000000000000000000010000000000000000000000000000000000000001
1000000000011111000111100000000000000001000000000000000000000000000000000000000000000000000100000000000000000000000000010000000000000000000000000000000000000001
1000000000010000000000000000000000000001000000000000000000000000000000000000000000000000000100000000000000000000000000010000000000000000000000000000000000000001
1000000000010000000000000000000000000001000000000000000000000000000000000000000000000000000100000000000000000000000000010000000000000000000000000000000000000001
1000000000010000000000000000000000000001000000000000000000000000000000000000000000000000000100000000000000000000000000010000000000000000000000000000000000000001
1000000000010000000000000000000000000001000000000000000000000000000000000000000000000000000000000000000000000000000000000000000000000000000000000000000000000001
1000000000010000000000000000000000000001000000000000000000000000000000000000000000000000000000000000000000000000000000000000000000000000000000000000000000000001
1000000000010000000000000000000000000001000000000000000000000000000000000000000000000000000000000000000000000000000000000000000000000000000000000000000000000001
1000000000010000000000000000000000000001000000000000000000000000000000000000000000000000000000000000000000000000000000000000000000000000000000000000000000000001
1000000000010000000000000000000000000001000000000000000000000000000000000000000000000000000000000000000000000000000000000000000000000000000000000000000000000001
1000000000010000000000000000000000000001000000000000000000000000000000000000000000000000000000000000000000000000000000000000000000000000000000000000000000000001
1111101111110000000000000000000000000001000000000000000000000000000000000000000000000000000100000000000000000000000000010000000000000000000000000000000000000001
1000000000000000000000000000000000000001000000000000000000000000000000000000000000000000000100000000000000000000000000010000000000000000000000000000000000000001
1000000000000000000000000000000000000001000000000000000000001111111111111111111100000000000100000000000000000000000000010000000000000000000000000000000000000001
1000000000000000000000000000000000000001000000000000000000000000000000000000000000000000000100000000000000000000000000010000000000000000000000000000000000000001
1000000000000000000000000000000000000001000000000000000000000000000000000000000000000000000100000000000000000000000000010000000000000000000000000000000000000001
1000000000000000000000000000000000000001000000000000000000000000000000000000000000000000000100000000000000000000000000010000000000000000000000000000000000000001
1111111111111110000000011111111100011111000000000000000000000000000000000000000000000000000100000000000000000000000000010000000000000000000000000000000000000001
1000000000010000000000000010000000000001000000000000000000000000000000000000000000000000000100000000000000000000000000010000000000000000000000000000000000000001
1000000000010000000000000010000000000001000000000000000000000000000000000000000000000000000100000000000000000000000000010000000000000000000000000000000000000001
1000000000000000000000000000000000000001000000000000000000000000000000000000000000000000000100000000000000000000000000010000000000000000000000000000000000000001
1000000000000000000000000000000000000001000000000000000000000000000000000000000000000000000100000000000000000000000000010000000000000000000000000000000000000001
1000000000010000000000000010000000000001000000000000000000000000000000000000000000000000000100000000000000000000000000010000000000000000000000000000000000000001
1000000000010000000000000010000000000001000000000000000000000000000000000000000000000000000100000000000000000000000000010000000000000000000000000000000000000001
1111111111111111111111111111111111111111111111111111111111111111111111111111111111111111111111111111111111111111111111111111111111111111111111111111111111111111
