80 60
11111111111111111111111111111111111111111111111111111111111111111111111111111111
10000000000100000000000000000000000000010000000000000000000000000000000000000001
10000000000100000000000000000000000000010000000000000000000000000000000000000001
10000000000100000000000000000000000000010000000000011111111111100000000000000001
10000000000100000000000000000000000000010000000000010000000000100000000000000001
10000000000100000000000000000000000000010000000000010000000000100000000000000001
10000000000100000000000000000000000000000000000000010000000000100000000000000001
11100000011100000000000000000000000000000000000000000000000000100000000000000001
10000000000100000000000000000000000000000000000000000000000000100000000000000001
10000000000100000000000000000000000000000000000000010000000000100000000000000001
10000000000100000000000000000000000000010000000000011111111111100000000000000001
10000000000100000000000000000000000000010000000000000000000000000000000000000001
10000000000100000000000000000000000000010000000000000000000000000000000000000001
10000000000100000000000000000000000000010000000000000000000000000000000000000001
10000000000100000000000000000000000000010000000000000000000000000000000000000001
10000000000100000000000000000000000000010000000000000000000000000000000000000001
10000000000100000000000000000000000000010000000000000000000000000000000000000001
10000000000100000000000000000000000000010000000000000000000000000000000000000001
10000000000100000000000000000000000000010000000000000000000000000000000000000001
11100000011111111111111111111111111111110000000000000000000000000000000000000001
10000000000100000000000000010000000000000000000000000000000000000000000000000001
10000000000100000000000000010000000000000000000000111111111111100000000000000001
10000000000100000000000000010000000000000000000000100000000000100000000000000001
10000000000100000000000000010000000000000000000000100000000000100000000000000001
10000000000100000000000000010000000000000000000000100000000000100000000000000001
10000000000100000000000000010000000000000000000000100000000000000000000000000001
10000000000000000000000000010000000000000000000000100000000000100000000000000001
10000000000100000000000000010000000000000000000000100000000000100000000000000001
10000000000100000000000000010000000000000000000000100000000000100000000000000001
10000000000100000000000000010000000000000000000000111111111111100000000000000001
11110000111111111111111111110000000000000000000000000000000000000000000000000001
10000000000100000000001000000000000000000000000000000000000000000000000000000001
10000000000100000000001000000000000000000000000000000000000000000000000000000001
10000000000100000000001000000000000000011111111111111111111111111111110000000001
10000000000100000000001000000000000000010000000000000000000000000000000000000001
10000000000100000000001000000000000000010000000000000000000000000000000000000001
10000000000111110001111000000000000000010000000000000000000000000000000000000001
10000000000100000000000000000000000000010000000000000000000000000000000000000001
10000000000100000000000000000000000000010000000000000000000000000000000000000001
10000000000100000000000000000000000000010000000000000000000000000000000000000001
10000000000100000000000000000000000000010000000000000000000000000000000000000001
10000000000100000000000000000000000000010000000000000000000000000000000000000001
10000000000100000000000000000000000000010000000000000000000000000000000000000001
10000000000100000000000000000000000000010000000000000000000000000000000000000001
10000000000100000000000000000000000000010000000000000000000000000000000000000001
10000000000100000000000000000000000000010000000000000000000000000000000000000001
11111011111100000000000000000000000000010000000000000000000000000000000000000001
10000000000000000000000000000000000000010000000000000000000000000000000000000001
10000000000000000000000000000000000000010000000000000000000011111111111111111111
10000000000000000000000000000000000000010000000000000000000000000000000000000001
10000000000000000000000000000000000000010000000000000000000000000000000000000001
10000000000000000000000000000000000000010000000000000000000000000000000000000001
11111111111111100000000111111111000111110000000000000000000000000000000000000001
10000000000100000000000000100000000000010000000000000000000000000000000000000001
10000000000100000000000000100000000000010000000000000000000000000000000000000001
10000000000000000000000000000000000000010000000000000000000000000000000000000001
10000000000000000000000000000000000000010000000000000000000000000000000000000001
10000000000100000000000000100000000000010000000000000000000000000000000000000001
10000000000100000000000000100000000000010000000000000000000000000000000000000001
11111111111111111111111111111111111111111111111111111111111111111111111111111111
