40 50
1111111111111111111111111111111111111111
1000000000000000000000000000000000000001
1000000000000000000000000000000000000001
1000000000000000000000000000000000000001
1000000000000000000000000000000000000001
1000000000000000000000000000000000000001
1000001000000000000000000000000001000001
1000001000000000000000000000000001000001
1000001111000000000000000000000111000001
1000000000000000000000000000000000000001
1000000000000000000000000000000000000001
1000000000000000000000000000000000000001
1000000000000000000000000000000000000001
1000000000001111101111110000000000000001
1000000000001000000000010000000000000001
1000000000001000000000010000000000000001
1000000000001000000000010000000000000001
0000000000001000000000010000000000000001
0000000000000000000000000000000000000001
0000000000001000000000010000000000000001
1000000000001000000000010000000000000001
1000000000001000000000010000000000000001
1000000000001000000000010000000000000001
1000000000001111110111110000000000000001
1000000000000000000000000000000000000001
1000000000000000000000000000000000000001
1000000000000000000000000000000000000001
1000000000000000000000000000000000000001
1000000000000000000000000000000000000001
1000000000000000000000000000000000000001
1000000000000000000000000000000000000001
1000100000000000000000000000000000000001
1000010000000000000000000011111110000001
1000001000000000000000000010000010000001
1000000100000000000000000010000010000001
1000000010000000000000000011101110000001
1000000001000000000000000000000000000001
1000000000000000000000000000000000000001
1000000000000000000000000000000000000001
1000000000000000000000000000000000000001
1000000000000000000000000000000000000001
1000000000000000000000000000000000000001
1000000000000000000000000000000000000001
1000000000000000000000000000000000000001
1000000000000000000000000000000000000001
1000000000000000000000000000000000000001
1000000000000000000000000000000000000001
1000000000000000000000000000000000000001
1000000000000000000000000000000000000001
1111111111111111111111111111111111111111
